Di Di Di Di Di Di Di Di
Di Di Di Vd Vd Di Di Di
Di Di Di Di Di Di Di Di
Di Vd Di Di Di Di Vd Di
Di Vd Di Di Di Di Vd Di
Di Di Di Di Di Di Di Di
Di Di Di Vd Vd Di Di Di
Di Di Di Di Di Di Di Di
